{
    "level": {
        "title": "It's the same with more coins",
        "enemies": "20",
        "layout": [
            "..............................................................",
            "..............................................................",
            "..............................................................",
            "................................s.............................",
            "..............................................................",
            "..............................................................",
            "..............................................................",
            "..............................................................",
            ".......................o......................................",
            "...................xxxxxx.....................................",
            ".........o..............w............................xxx......",
            "x.......xxxxx...........w..............................w......",
            "w.......................w..............................w......",
            "w..........o............w..............................x......",
            "x.......xxxxx...........w..........................o..x.......",
            "........................w............................x........",
            "........................w...........................x.........",
            ".....p............o.....w.......!.........o........x......d...",
            "xxxxxxxxxxxxxxxxxxxxxxxxxxxxxxxxxxxxxxxxxxxxxxxxxxxxxxxxxxxxxx"
        ]
    }
}