{
    "level": {
        "title": "It all begin here",
        "enemies": "20",
        "layout": [
            "xxxxxxxxxxxxxxxxxxxxxxxxxxxxxxxxxxxxxxxxxxxxxxxxxxxxxxxxxxxxxx",
            "w............................................................w",
            "w............................................................w",
            "w...............................s............................w",
            "w............................................................w",
            "w............................................................w",
            "w............................................................w",
            "w............................................................w",
            "w............................................................w",
            "w............................................................w",
            "w............................................................w",
            "w............................................................w",
            "w............................................................w",
            "w............................................................w",
            "w............................................................w",
            "w............................................................w",
            "w............................................................w",
            "w....p............o.............!....................d.......w",
            "xxxxxxxxxxxxxxxxxxxxxxxxxxxxxxxxxxxxxxxxxxxxxxxxxxxxxxxxxxxxxx"
        ]
    }
}