{
    "level": {
        "title": "It's a test stage",
        "enemies" : "20",
        "layout": [
            "..............................................................",
            "..............................................................",
            "..............................................................",
            "................................s.............................",
            "..............................................................",
            "..............................................................",
            "..............................................................",
            "..............................................................",
            "..............................................................",
            "...................xxxxxx.....................................",
            "........................w.....................................",
            "x.......xxxxx...........w.....................................",
            "w.......................w.....................................",
            "w.......................w.....................................",
            "x.......xxxxx...........w.....................................",
            "........................w.....................................",
            "........................w.....................................",
            ".....p............o.....w.......!....................d........",
            "xxxxxxxxxxxxxxxxxxxxxxxxxxxxxxxxxxxxxxxxxxxxxxxxxxxxxxxxxxxxxx"
        ]
    }
}